

5 5
0 0 0 0 0
0 A 0 0 D
0 0 0 0 0
0 B 0 C 0
R 0 0 0 0